Debbie	Douglas
Holly	Doyle
Brett	Russell
Marshall	Henderson
Carrie	Lucas
Sophia	Bush
Keith	Shaw
Penny	Hunt
Ora	Roberson
Chad	Harmon
Gwendolyn	West
Ann	Gross
Mona	Morrison
Wilbur	Pratt
Janet	Cummings
Steve	Crawford
Ken	Wilkerson
Kendra	Parsons
Alison	Herrera
Emma	Wong
Wesley	Bowen
Andres	Brock
Gerard	Becker
Jo	Lindsey
Kelly	Flores
Annie	Francis
Leona	Boyd
Maurice	Morgan
Nadine	Powell
Douglas	Gilbert
Wilson	Jackson
Lorene	Hines
Bryant	Newton
Sandra	Johnson
Lorraine	Moss
Maggie	Barker
Bradford	Ford
Kevin	Curtis
Pearl	Higgins
Israel	Hansen
Margie	Mcbride
Christie	Rios
Mercedes	Buchanan
Donnie	Sparks
Dominick	Burgess
Vicky	Phillips
Marty	Oliver
Daniel	Munoz
Rudy	Padilla
Jonathan	Simmons
Delores	Hicks
Rogelio	Sutton
Florence	Pearson
Denise	Conner
Roman	Barnett
Sonya	Burns
Yvonne	Hodges
Nelson	Bell
Violet	Kennedy
Lindsey	Salazar
Sergio	Fletcher
James	Taylor
Lowell	Quinn
Glenda	Anderson
Adrian	Santos
Lori	Chambers
Lynda	Nichols
Daryl	Mcgee
Pedro	Curry
Pam	Ellis
Shelia	May
Lena	Tyler
Tracy	Daniel
Crystal	Gomez
Tommy	Joseph
Latoya	Ross
Todd	Hopkins
Sheldon	Perkins
Geneva	Myers
Ernesto	Clarke
Emmett	Stokes
Lydia	Murray
Wendy	Valdez
Thomas	Page
Calvin	Owen
Melody	Underwood
Estelle	Weaver
Nettie	Robertson
Nellie	Edwards
Bob	Cobb
Josephine	Santiago
Eddie	Reed
Sonia	Griffith
Danny	Hart
Esther	Gonzalez
Everett	Robinson
Terri	Gregory
Carmen	Collins
Howard	Ortiz
Willis	Saunders
Cary	Flores
Nicolas	Mann
Michelle	Mclaughlin
Brandi	Phelps
Bert	Hines
Emma	Peterson
Jessie	Barnett
Lynn	Ruiz
Glenn	Gutierrez
Terry	Love
Phillip	Thompson
Annie	Graham
Minnie	Andrews
Micheal	Ramirez
Lewis	Kim
Lola	Lawrence
Josh	Morales
Ira	Lopez
Lucille	Fernandez
Stephanie	Dennis
Blanche	Newman
Julia	Weaver
Adrian	Oliver
Dexter	Simpson
Franklin	Morrison
Jana	Jenkins
Clinton	Price
Eloise	Ramos
Sonja	Walton
Regina	Hampton
Colin	Cobb
Julio	Mack
Pete	Moore
Rose	Holland
Clayton	Knight
Leroy	Mccormick
Rudy	Torres
Chad	Hanson
Lorenzo	Ford
Steven	Day
Belinda	Sparks
Chelsea	Adkins
Rodolfo	Sanders
Samantha	Chandler
Sheryl	Banks
Jeffrey	Mills
Randy	Webster
Stuart	Malone
Carmen	Zimmerman
Courtney	Hopkins
Brenda	Caldwell
Cynthia	Clayton
Jody	Soto
Conrad	Ball
Ginger	Holmes
Doreen	Stokes
Travis	Ward
Lee	Coleman
Elaine	Reid
Tyler	Hogan
Inez	Pope
Kerry	Patterson
Jackie	Alexander
Agnes	Francis
Ed	Salazar
Bruce	Underwood
Sharon	Reeves
Patti	Cortez
Frank	Parks
Joseph	Kelly
Olivia	Crawford
Lucas	Schmidt
Curtis	Adams
Gary	Green
Stephen	Tran
Randal	Gonzalez
Sandy	Johnson
Judith	Doyle
Kristine	Jackson
Nelson	Jordan
Myron	Stevenson
Rachel	Mcdaniel
Christopher	Lowe
Melinda	Townsend
Misty	Gardner
Alma	Warren
Brandon	Fletcher
Sarah	Willis
Josephine	Campbell
Tim	Bass
Suzanne	Tyler
Bryant	Abbott
Christie	Gomez
Kelley	Brock
Ian	Rodriguez
Clarence	Powell
Claude	Bowman
Sylvester	Howard
Kathleen	Hubbard
Harold	Carpenter
Carlos	Cummings
Cecil	Walsh
Kirk	Fletcher
Anna	Lee
Jordan	Jones
Blanche	Welch
Kerry	Mckinney
Kara	Caldwell
Joe	Stone
Beverly	Wright
Michelle	French
Kerry	Malone
Meghan	Hopkins
Judy	Larson
Carole	Glover
Sylvia	Schneider
Eddie	Sandoval
Cora	Haynes
Raul	Conner
Ramon	Marshall
Lee	Quinn
Joshua	Herrera
Lisa	Mack
Kari	Parker
Roberto	Brooks
Felicia	Todd
Dolores	Buchanan
Zachary	Flores
Wilfred	Boone
Jon	Bowman
Javier	Miller
Linda	Aguilar
Albert	Hanson
Nancy	Norris
Joan	Boyd
Mario	Carter
Rodolfo	Garcia
Kurt	Morris
Kayla	Saunders
Catherine	Lloyd
Julia	Blake
Clifton	Obrien
Roderick	Cannon
Casey	Higgins
Gwen	Powers
Kent	Park
Martha	Collins
Lula	Dawson
Raquel	Hampton
Sergio	Sharp
Dwight	Mendez
Tara	Cook
Francis	Underwood
Lester	Barnes
Helen	Barton
Tim	Davidson
Angie	Chapman
Colin	Neal
Bruce	Harper
Florence	Colon
Constance	Jensen
Shari	Salazar
Cathy	Terry
Melba	Murray
Isaac	Frazier
Conrad	Barker
Katrina	Washington
Noel	Richards
Ernestine	Bass
Al	Padilla
Ira	Cole
Denise	Ball
Sarah	Holland
Jose	Watkins
Peggy	Wilkins
Phyllis	Phelps
Kelley	Kelley
Virginia	Casey
Richard	Hubbard
Krystal	Mann
Joanna	Palmer
Cary	Newton
Elaine	Reeves
Rose	Young
Christie	Reese
Anita	Richardson
Norman	Webb
Theodore	Greene
Vernon	Howell
Bonnie	Byrd
Jackie	Hayes
Irma	Porter
Mattie	Torres
Joel	Joseph
Ronnie	Mullins
Kimberly	Kelly
Francis	Walker
Louis	Griffith
Janis	Curtis
Ernesto	Berry
Cindy	Mcdonald
Alberto	May
Kayla	Tucker
Elsa	Grant
Bernice	Ramsey
Cornelius	Cannon
Brenda	Klein
Clarence	Nelson
Helen	Jennings
Pedro	Ross
Brian	Mills
Olga	Thompson
Nathaniel	Schneider
Mark	Figueroa
Greg	Saunders
Marie	Stanley
Bobby	Banks
Lindsay	Colon
Tricia	Cain
Rosie	Lloyd
Shawn	Peterson
Leona	Holloway
Devin	Rice
Traci	Carroll
Courtney	Goodwin
Harriet	Boyd
Jeanne	Pierce
Allison	Blair
June	Sandoval
Norma	Howard
Larry	Flowers
Steve	Norris
Angelica	Chavez
Casey	Ruiz
Cedric	Steele
Marlene	Vargas
Lila	Barnett
Candace	Campbell
Melvin	Watson
Marcos	Castillo
Clark	Burke
Gertrude	Dean
Derek	Baldwin
Kyle	Caldwell
Kristin	Stevens
Terence	Casey
Randal	Gutierrez
Adrian	Frank
Luther	Smith
Beulah	Shelton
Gustavo	Sherman
Darrell	Lawrence
Bill	Jefferson
Nettie	Greer
Diana	Guerrero
Vicky	Hall
Milton	Tyler
Jerry	Vaughn
Joy	Wong
Ian	Black
Guy	Morales
Whitney	Blake
Carole	Mccoy
Kara	Lucas
Bennie	Henderson
Stacey	Bush
Blanche	Simmons
Angelo	Williamson
Alvin	Wells
Charles	Aguilar
Mattie	Lane
Terrence	Thomas
Rhonda	Bennett
Diane	Mcgee
Patsy	Riley
Randall	Gray
Lola	Luna
Erick	Beck
Noel	Roy
Adam	Bass
Stella	Parks
Darlene	Mclaughlin
Monique	Burns
Mabel	Moreno
Sherman	Simpson
Anita	Cohen
Shannon	Gibson
Maryann	Scott
Chelsea	Pratt
Alejandro	Robbins
Catherine	Maldonado
Sara	Norman
Timothy	Sharp
Johnny	Ford
Jay	Park
Todd	Padilla
Daryl	Moody
Sharon	Cross
Lynette	Hampton
Jody	Tate
Russell	Bennett
Darin	Ortiz
Phyllis	Patton
Ramon	Olson
Timothy	Hammond
Willie	Morrison
Jack	Hogan
April	Paul
Leo	Sims
Sheila	Mccormick
Dianne	Richardson
Stephen	Schwartz
Grace	Craig
Lorenzo	Owen
Salvatore	Fletcher
Marcos	Newman
Rene	Boone
Raquel	Ward
Cedric	Hughes
Delbert	Davidson
Della	Ballard
Garrett	Webster
Gerard	Powell
Rafael	Pittman
Brooke	Ruiz
Edward	Santiago
Henry	Walters
Jerald	Aguilar
Patty	Poole
Rhonda	Warren
Orville	Massey
Gordon	Lyons
Toby	Knight
Erma	Jefferson
Kristine	Bridges
Kara	Quinn
Elijah	Baker
Adrian	Burton
Jimmy	Wheeler
Martin	Greer
Alfred	Lindsey
Drew	Jacobs
Brett	Alexander
Lowell	Barber
Christina	Graham
Vernon	Martin
Rufus	Hernandez
Nina	Barnett
Van	Herrera
Shelley	Sparks
Janie	Wells
Robin	Kelly
Sandy	Klein
Cassandra	Hale
Frankie	Hopkins
Paul	Todd
Faye	Parker
Jackie	Lane
Jeremy	Harvey
Melba	Jenkins
Chester	Reed
Conrad	Mcgee
Geneva	Chandler
Jeanne	Salazar
Leona	Lamb
Kendra	Martinez
Jared	Ray
Sally	Weaver
Justin	Hines
Dominic	Hawkins
Julian	Barton
Dana	Foster
Shawna	Phillips
Lori	Stone
Misty	Potter
Delores	Cannon
Don	Cooper
Maxine	Casey
Rodney	Washington
Warren	Fisher
Dave	Saunders
Bennie	Boyd
Jesus	Manning
Rachel	Singleton
Arthur	Garcia
Jamie	Shaw
Muriel	Howell
Irma	Phelps
Helen	Powers
Shane	Hodges
Ronnie	George
Kerry	Robinson
Nellie	Lowe
Derrick	Gordon
Melvin	Wise
Felix	Porter
Floyd	Burke
Kellie	Vega
Nicolas	Bass
Patricia	Wilkins