Danelle	Goldman
Lanelle	Leroy
Alesia	Greco
Leilani	Ruffin
Myrta	Galindo
Shona	Laird
Kanesha	Borders
Randell	Smoot
Elida	Haggard
Louetta	Koehler
Ike	Acuna
Rosanna	Archibald
Margit	Keaton
Jonah	Kopp
Sammie	Boothe
Lashanda	Mauldin
Randy	Varela
Ariana	Woodall
Edra	Fortner
Bettie	Bynum
Martin	Strange
Vernon	Chaney
Nadia	Shaffer
Margorie	Beach
Geri	Foret
Adan	Puente
Nancey	Boss
Benito	Lance
Tereasa	Runyon
Chung	Begley
Michell	Chisholm
Kesha	High
Margaretta	Barrios
Donette	Catalano
Lashonda	Cantwell
Virgie	Breen
Kimber	Knowlton
Alfreda	Chan
Alana	Mchugh
Maddie	Iverson
Alysa	Hornsby
Maryetta	Marquis
Amal	Chisolm
Pinkie	Pauley
Babara	Quiroz
Lonnie	Whyte
Lorna	Dubose
Sherrell	Bautista
Lue	Zavala
Niki	Crowell
Hyun	Sneed
Russ	David
Reynalda	Shores
Mellisa	Rigby
Tamra	Blackmon
Maida	Wylie
Barbie	Musser
Ima	Bragg
Meridith	Saavedra
Kathryne	Bethea
Maisha	Carey
Amberly	Rosenbaum
Tillie	Stovall
Kennith	Rand
Dalia	Coppola
Chang	Gallo
Winnifred	Norfleet
Chang	Hussey
Malisa	Coburn
Lane	Decker
Kenda	Gillen
Fran	Maclean
Bari	Babcock
Harrison	Lassiter
Lakenya	Stoner
Farah	Hawley
Georgann	Estes
Candance	Delong
Lezlie	Noyes
Ariel	Covert
Mervin	Metz
Mellissa	Montero
Rossie	Mcgovern
Alpha	Tabor
Keith	Weatherford
Lakendra	Crocker
Yuki	Foust
Yung	Mccue
Irish	Arevalo
Trinidad	Unger
Ramonita	Kirkwood
Art	Richie
Allegra	Toro
Hallie	Bussey
Raisa	Oneill
Benedict	Nesbitt
Darci	Bender
Yong	Mireles
Delfina	Butcher
Pia	Falls
Ashly	Weinstein
Charity	Tinsley
Rosella	Nealy
Lorretta	Hornsby
Brett	Esposito
Fiona	Bickford
Lanell	Pease
Claudine	Stephenson
Holley	Antoine
Irina	Dell
Florine	Briseno
Walter	Gunderson
Alix	Farris
Bruna	Galvez
Stefany	Irby
Latosha	Gillis
Reyes	Pomeroy
Fanny	Kimball
Zonia	Kay
Angeles	Fanning
Starla	Gould
Anjelica	Irizarry
Damien	Horan
Rory	Seeley
Eliza	Loera
Marylouise	Sikes
Francene	Han
Pamula	Colson
Olimpia	Back
Jolyn	Camacho
Deadra	Orta
Tori	Wyman
Ivelisse	Churchill
Keva	Delarosa
Arlyne	Frame
Marcelene	Hackett
Jenette	Bravo
Pinkie	Mcallister
Michelina	Vu
Simona	Lyon
Laurena	Townes
Melodi	Rush
Dorathy	Mcmillen
Brigid	Sorrell
Gerald	Seals
Oren	Bloom
Sol	Guthrie
Antonetta	Breedlove
Renetta	Spence
Agustina	Ritchey
Jenniffer	Rucker
Kizzy	Payton
Britta	Batten
Rich	Aiken
Minh	Coughlin
Man	Gomes
Richie	Moon
Antionette	Godfrey
Kimberli	Salmon
Estell	Rayford
Lindsay	Razo
Buddy	Arriaga
Caridad	Hawk
Rayna	Ammons
Daphne	Brockman
Katlyn	Gerard
Elza	Kohl
Yee	Lynn
Tiffaney	Grayson
Phylis	Zeigler
Dara	Lenz
Sharda	Arrington
Elenore	Batts
Morton	Bordelon
Clarine	John
Senaida	Fountain
Chantell	Bandy
Maribel	Schiller
Gabriela	Bernal
Malissa	Christian
Sage	Dugan
Glinda	Mosher
Kesha	Haller
Rocio	Beverly
Jina	Beach
Elke	Light
Janine	Goad
Luetta	Spriggs
Ela	Herron
Cherly	Fagan
Odis	Easterling
Desire	Cushman
Arielle	Durham
Verline	Escalante
Genia	Otoole
Migdalia	Loyd
Loreta	Coffin
Ha	Staten
Celeste	Oakes
Santa	Keeler
Avelina	Leighton
Verla	Flanders
Christel	Mccorkle
Tyree	Cloutier
Glinda	Lutz
Karly	Jorgenson
Regena	Ginn
Inga	Hawthorne
Anitra	Peek
Truman	Packard
Minta	Marcum
Major	Bunch
Valene	Land
Sabina	Curley
Liza	Atwell
Kandi	Utley
Clarissa	Aquino
Claudie	Eagle
Adele	Berrios
Giuseppe	Petrie
Robbie	Ferrari
Debroah	Fontaine
Lourdes	Dennison
Lili	Whitcomb
Landon	Spence
Jaunita	Olivarez
Wilda	Emerson
Rubi	Mohr
Lashonda	Mahon
Fe	Humphreys
Marlin	Engle
Cherelle	Cameron
Jacques	Mcghee
Treva	Sprouse
Vonnie	Akins
Cliff	Bounds
Deirdre	Lentz
Leta	Nix
Odessa	Willey
Bao	Luttrell
Arline	Agee
Carlita	Gerald
Orpha	Leigh
Christinia	Oliphant
Santos	Roper
Merilyn	Pape
Alix	Weir
Erich	Lowman
Jade	Bower
Takako	Bullock
Min	Blaine
Hue	Kaplan
Eliz	Tillery
Rosio	Elkins
Kayleen	Eastman
Gabriele	Leggett
Emilia	Reichert
Marhta	Guevara
Zandra	Randall
Rolanda	Ziegler
Man	Rutledge
Kamala	Ponder
Wava	Lapointe
Dino	Cyr
Tessa	Gant
Aurora	Will
Cristin	Mcnutt
Clotilde	Aldrich
Arnulfo	Dwyer
Ariane	Wimberly
Lesli	Bourque
Jewell	Fitch
Dorinda	Mccaffrey
Bambi	Coon
Tyler	Temple
Warner	Bartlett
James	Currier
Lady	Keeler
Meagan	Judd
Adriane	Ma
Shad	Ham
Kia	Davies
Terresa	Burchfield
Lizzie	Garris
Quyen	Cleary
Mac	Cota
Felton	Renner
Donnie	Weston
Fallon	Elder
Tisa	Vanhorn
Kimbra	Wentworth
Lynetta	Fugate
Thresa	Binder
Ericka	Kay
Chuck	Chalmers
Mistie	Hoff
Clarisa	Peyton
Bulah	Aragon
Mackenzie	Ripley
Ashely	Herndon
Harland	Hooker
Darwin	Ashby
Salome	Pridgen
Thomasine	Baugh
Luna	Farrington
Marquetta	Mintz
Wilmer	Zuniga
Dwain	Frias
Lessie	Shipman
Zetta	See
Shae	Ott
Jamel	Albrecht
Thea	Council
Sanda	Joiner
Jerold	Corcoran
Maryjane	Villalobos
Sueann	Bedford
Isabelle	Farnsworth
Mitsuko	Wellman
Jenae	Jeter
Kalyn	Bright
Merna	Trevino
Marylin	Goetz
Rosann	Sykes
Vicenta	Durand
Sirena	Nunley
Petra	Caraballo
Aleshia	Pinckney
Norbert	Puente
Chantell	Keel
Leda	Munn
Yetta	Bayne
Duncan	Magee
Mayme	Darnell
Jennette	Trotter
Giovanna	Overton
Maye	Dickens
Catharine	Light
Nga	Cooks
Shanelle	Rowell
Carlene	Giroux
Donetta	Cooke
Pamila	Burney
Keva	Pollock
Trish	Belanger
Galen	Villareal
Toshia	Downs
Jason	Dennison
Mazie	Wahl
Alejandra	Bingham
Grover	Kahn
Donnell	Lentz
Desirae	Sheets
Jackson	Tibbetts
Vicente	Schulz
Latia	Crane
Felecia	Mount
Tammara	Truitt
Janel	Meyers
Martina	Arias
Emerald	Mcdaniels
Reita	Hendricks
Debrah	Sprague
Beata	Dowd
Shelby	Shepherd
Robena	Laird
Katheleen	Pruitt
Mathilda	Peeler
Lashandra	Nielsen
Roma	Layne
Trena	Briscoe
Rigoberto	Cervantes
Mira	Nieto
Caron	Weathers
Lyndsey	Gaddis
Sacha	Crum
Karissa	Saucedo
Vanna	Dasilva
Lorie	Khan
Dessie	Macdonald
Ike	Prescott
Diego	Levesque
Milagro	Welker
Emmy	Booth
Yuonne	Reaves
Jessi	Mears
Trista	Cambell
Efrain	Hadden
Alda	Chavis
Charlie	Couture
Raina	Mcclelland
Quinn	Martins
Brenna	Soriano
Brittny	Barnhart
Asley	Law
Lory	Abernathy
Edda	Rosales
Sondra	Barden
Valarie	Bunnell
Lea	Easley
Danilo	Otoole
Mei	Burkholder
Mammie	Garber
Bailey	Frost
Lonna	Amador
Candi	Lacey
Robbie	Lehmann
Evelin	Blackburn
Domenica	Alaniz
Jonna	Anthony
Hannelore	Lassiter
Stefania	Mcgovern
Syble	Fitzsimmons
Bennett	Mohr
Trent	Cyr
Tommy	Stout
Annabelle	Nowlin
Milo	Rockwell
Jeannine	Jewell
Kenisha	Hindman
Eugenio	Hagen
Deidre	Matheny
Sasha	Larkin
Annmarie	August
Dulce	Ocasio
Marcelo	Kendrick
Shoshana	Foreman
Magnolia	Wallen
Claudio	Emmons
Wiley	Gates
Gregorio	Ledesma
Temika	Woodson
Yuko	Neill
Joycelyn	Hanley
Regena	Leger
Na	Cornelius
Leonia	Parson
Julienne	Cobbs
Linn	Montanez
Buck	March
Luciano	Hailey
Emmie	Bartlett
Nova	Broderick
Twyla	Holly
Faustina	Teague
Caprice	Dickerson
Leandra	Thacker
Olimpia	Boyer
Margert	Calvert
Moira	Tomlin
Starr	Meehan
Clelia	Bruton
Sherly	Soliz
Delisa	Lam
Stephan	Martz
Belia	Potts
Araceli	Penny
Rema	Gunther
Tona	Pannell
Mercy	Crouse
Rolland	Saucedo
Pia	Lawton
Sanora	Cash
Hermine	Huskey
Alyse	Oglesby
Marya	Dugan
Roxann	Vance
Santina	Caskey
Yuette	Boles
Shelli	Valles
Le	Sledge
Dina	Bertram
Tequila	Carden
Shella	Freitas
Roseanna	Pike
Kazuko	Ponce
Sammie	Puente
Pamella	Brink
Ha	Hickson
Charley	Trout
Lolita	Corbitt
Marina	Ault
Lavonna	Wray
Victor	Moriarty
Kylie	Chong
Zita	Hawks
Mitsue	Keeler
Robena	Paige
Carlene	Roth
Darcey	Simpkins
Colton	Keefe
Izetta	Singh
Vanna	Marino
Bula	Hawes
Lashawn	Bills
Latesha	Woodbury
Octavia	Shipman
Denita	Hoyle
Myrna	Fournier
Shandi	Lim